NO ./path_to_the_north_texture
SO ./path_to_the_south_texture
WE ./path_to_the_west_texture
EA ./path_to_the_east_texture

F 220,100,0
C 220,100,0

   11111111111111
   10000000000001
   11110000111001
   11000000001111
10000000001111111
10000000000000001
10101001111111111